######################
#                    #
#                    #
#                    #
#                    #
#              S     #
#                    #
#                    #
# S     A            #
#                    #
######################
